====================
=======...........==
=======.======.=====
======..======.=====
======.=======.=====
======.=======.=====
===.......====.=====
==============.=====
E.S............=====
==============.=====
===......=====.=====
===.==.=======.=====
===.==.=======.=====
===.==.=======.=====
===.==..======.=====
===.===........=====
===.================
===.================
===...............==
====================


