====================
=========.==========
=========.==========
=========.==========
=========.==========
=========.==========
=========.==========
=========.==========
=........S.........=
=========.==========
=========.==========
=========.==========
=========.==========
=========.==========
=========.==========
=========.==========
=========.==========
=========.==========
=========.==========
=========E==========


