E.==================
=.==================
=..................=
======.========.====
======.======......=
=================..=
=............===...=
===========........=
================.===
===========........=
==================.S
==================.=
=..............==..=
=========.=.=...=..=
=====.===......=...=
=====.......========
===========......===
=............=======
============.......=
====================
