====================
=................===
================.===
================.===
================.===
======.............=
===========.========
=========.......====
=============S======
=============.======
=============.======
=..................=
====.============.==
====..............==
=====....====..=====
==============.=====
==============.=====
==============.=====
==============.=====
==============E=====
