====================
S..................=
==================.=
=..................=
===.================
=..................=
==================.=
=..................=
=.==================
=..................=
==================.=
=..................=
=.==================
=.==================
=............=======
============.=======
============.=======
============.=======
=..................=
=E==================