==========
===E.....=
=====...==
======..==
=======.==
=======.==
=======.==
=======.==
=======S==
==========
