==================================
============================...E==
============================.=====
===========......................=
==================.==========.====
==================..............S=
==================================
